home=Начало
articles=Стоки
catalog=Каталог
order=Поръчка
list=Опис
user=Потребител
password=Парола
repeatPassword=Повтори парола
organisation=Организация, фирма
login=Вход
logout=Изход
createAccount=Регистрация
adminPanel=Администриране
refresh=Опресняване
add=Добавяне
delete=Изтриване
show=Покажи
rows=реда
from=от
first=Първа
last=Последна
previous=Предишна
next=Следваща
save=Записване
cancel=Изход
itemgroup=Артикулна група
itemgroup1=Група
itemgroups=Артикулни групи
homeinfo=Начална информация
homeinfos=Начална информация
item=Артикул
items=Артикули
order=Поръчка
orders=Поръчки
user=Потребител
users=Потребители
id=Id
namebg=Наименование Bg
nameen=Наименование En
name=Наименование
headerbg=Заглавие Bg
headeren=Заглавие En
textbg=Текст Bg
texten=Текст En
selectItemsToDelete=Изберете редове за изтриване.
username=Потребител
password=Парола
fullname=Име
organisation=Организация
email=Email
lastlogin=Последно влизане
lastloginip=IP адрес
adminflag=Админ.
packingbg=Опаковка Bg
packingen=Опаковка En
packing=Опаковка
measureunitbg=Мерна ед. Bg
measureuniten=Мерна ед. En
amountinpacking=К-во в опак.
priceforpacking=Цена за опак.
promotion=Промоция
promotion1=Пром.
promotions=Промоции
invalidGroup=Невалидна група.
descriptionbg=Описание Bg
descriptionen=Описание En
valueNotANumber=Въведената стойност не е число.
uploadimage=Качване на картинка за артикул
upload=Качи
picture=Карт.
fromdate=От дата
todate=До дата
postdate=Пусната на дата/час
fordate=За дата/час
delivdate=Дата на доставка
delivtime=Час на доставка 
status=Статус
delivAddress=Адрес на доставка
endDateBeforeStartDate=Крайната дата е преди началната.
udatestatus=Смени статус
cancelstatus=Анулиране на поръчката
number=Номер
quantity=Количество
price=Цена
measure=Мярка
value=Стойност
pricesAreWoVat=Цените са в лева с включен ДДС.
producer=Производител
producers=Производители
pagetitleprefix=BiolVarna
homepagetitle=Начална страница
leva=лв.
search=Търсене
enterNameForSearch=Въведете наименование или част от него за търсене в артикулите.
ordernow=Поръчай сега
total=Общо
confirmdeleterow=Желаете ли да изтриете реда?
confirmdeleteitems=Желаете ли да изтриете избраните редове?
noorderrows=Няма редове в поръчката.
toPostOrderUserMustLogin=За да запишете поръчката трябва да влезете с вашето потребителско име и парола.
toCancelOrderUserMustLogin=За да анулирате поръчката трябва да влезете с вашето потребителско име и парола.
confirmpostorder=Желаете ли да запишете поръчката?
provideUsernamePassword=Въведете потребителско име и парола.
invalidUsernamePassword=Невалиден потребител / парола.
registration=Регистрация
enterRegCode=Код за регистрация
regCodeHintText=Въведете показания код.
registrationDone1=Вашата регистрация премина успешно. 
registrationDone2=Може да въведете потребителското си име и парола и да влезете в системата.
usernameHintText1=Може да съдържа само латински букви
usernameHintText2=(a-z) или цифри 0-9, "." и "_".
usernameHintText3=Трябва да започва с буква.
usernameHintText4=Дължина от 3 до 30 символа.
passwordHintText1=Може да съдържа малки и големи латински букви,
passwordHintText2=цифри и символи. Дължина от 6 до 30 символа.
passwordHintText3=Не въвеждайте потребителското си име,
passwordHintText4=други имена или дати за парола.
invalidValue=Съдържа невалидни символи или невалидна дължина.
usernameExists=Потребител с такова име вече съществува.
passwordNotMatch=Паролата не съвпада.
usernameEqualsPassword=Потребителското име не може да съвпада с паролата.
regCodeNotMatches=Кодът за регистрация не съвпада.
validUsername=Потребителското име е валидно.
confirmCancelOrder=Желаете ли да анулирате поръчката?    
dataSavedOK=Данните са записани успешно.
orderCanceled=Поръчката е анулирана успешно.
toSeeThisInfoMustLogin=За да видите тази страница трябва да влезете с вашето потребителско име и парола.
invalidParamOrRecordDeleted=Невалиден параметър или записът е изтрит.
orderIsFromOtherUser=Нямате права да достъпвате тази информация.
newArticles=Нови
cheapesArticles=Най-евтини
bestSellArticles=Най-продавани
bestSellArticles1=Най-прод.
bgmapsLocation=Използвайте линка, за да видите къде се намира складовата ни база 
skypeContact=Свържете се с отдел продажби чрез Skype